###################################
###G        G               G    H#
############ ######################
######        G           G   #####
########## ########################
######G              G     ########
#################### ##############
########          G          G#####
################## ################
######                      #######
########################## ########
###G      G               G########
########### #######################
####  G                    G#######
####### ###########################
###G          G             G######
######### #########################
#####G            G            G###
########################## ########
#@        G                     G##
###################################