###################################
#                                 #
#                                 #
#                                 #
#                                 #
#                                 #
#                                 #
#             #######             #
#             #GGGGG#             #
#             #GGGGG#             #
#             ### ###             #
#                                 #
#                                 #
#                                 #
#                                 #
#                                 #
#                                 #
#                                 #
#                                 #
#H@                               #
###################################